###############################
#S             #  #  #  #     #
#  #  ####  ####  #  #  ####  #
#  #     #     #     #        #
#  ##########  ####  #  ####  #
#     #                 #     #
#######  ####  #############  #
#        #     #  #  #  #     #
####  #  #######  #  #  #  #  #
#  #  #     #           #  #  #
#  #  #  #  #######  #  #  ####
#  #  #  #           #  #     #
#  ####  #  #  ####  #######  #
#        #  #     #  #     #  #
#  ######################  #  #
#     #           #        #  #
#  #  #  ##########  ####  #  #
#  #     #              #  #  #
#  #  #  #  ####  ####  #  #  #
#  #  #  #  #     #     #    E#
###############################
