##################
#S               #
#                #
#                #
#                #
#               E#
##################
